"RoomID","Rent","Category"
"R01","1000","X"
"R02","2000","Y"
"R03","3000","Z"
"R04","4000","X"
"R05","5000","Y"
"R06","6000","Z"
